Search results for "L"
CITY NAME	3-LETTER CITY CODE	AIRPORT NAME	3-LETTER AIRPORT CODE
A Coruna	LCG	Airport	LCG
Aklavik	LAK	Freddie Carmichael	LAK
Albi	LBI	Le Sequestre	LBI
Aleg	LEG	Aleg	LEG
Almeria	LEI	Airport	LEI
Altai	LTI	Altai	LTI
Altus	LTS	Quartz Moutain Rgnl	AXS
Altus	LTS	Metropolitan Area	LTS
Altus	LTS	AFB	LTS
Angleton/Lake Jackson	LJN	Texas Gulf Coast Rgnl	LJN
Aurora	LDO	Laduani	LDO
Balcanoona	LCN	Balcanoona	LCN
Beida	LAQ	Labraq	LAQ
Bom Jesus da Lapa	LAZ	Bom Jesus da Lapa	LAZ
Brandon	LKZ	Lakenheath RAF	LKZ
Cape Lisburne	LUR	Cape Lisburne	LUR
Chillagoe	LLG	Chillagoe	LLG
Cincinnati	CVG	Municipal (Lunken Fld)	LUK
Cochrane	LGR	Cochrane	LGR
Columbus	CMH	Rickenbacker Intl	LCK
Columbus	CSG	Lawson AAF-Ft Benning	LSF
Deadmans Cay	LGI	Deadmans Cay	LGI
Derry	LDY	Eglinton	LDY
El Trapiche	LMX	Lopez de Micay	LMX
Ely	LYU	Municipal	LYU
Faisalabad	LYP	International	LYP
Gapuwiyak	LEL	Lake Evella	LEL
Ghadames	LTD	Ghadames	LTD
Gran Canaria	LPA	Gran Canaria	LPA
Gyumri	LWN	Shirak	LWN
Hamburg	HAM	Luebeck-Blankensee	LBC
Hampton	LFI	Langley AFB	LFI
Hattiesburg/Laurel	LUL	Bobby L. Chain Muni	HBG
Hattiesburg/Laurel	LUL	Metropolitan Area	LUL
Hattiesburg/Laurel	LUL	Hesler-Noble Field	LUL
Hattiesburg/Laurel	LUL	Regional	PIB
Hinesville/Ft Stewart	LIY	MidCoast Regional	LIY
Jacksonville	LRF	Little Rock AFB	LRF
Kalaupapa	LUP	Kalaupapa	LUP
Kelafo	LFO	Kelafo	LFO
Kelila	LLN	Kelila	LLN
Khujand	LBD	International	LBD
Kiriwina Island	LSA	Losuia	LSA
Klamath Falls	LMT	Klamath Falls	LMT
Kulik Lake	LKK	Kulik Lake	LKK
La Baule-Escoublac	LBY	La Baule-Escoublac	LBY
La Ceiba	LCE	Goloson International	LCE
La Chorrera	LCR	La Chorrera	LCR
La Crosse	LSE	Regional	LSE
La Cumbre	LCM	La Cumbre	LCM
La Esperanza	LEZ	La Esperanza	LEZ
La Fria	LFR	La Fria	LFR
La Grande	LGD	Union County	LGD
La Grange	LGC	Callaway	LGC
La Macarena	LMC	La Macarena	LMC
La Paz	LAP	Manuel Marquez de Leon	LAP
La Paz	LPB	El Alto Intl	LPB
La Pedrera	LPD	La Pedrera	LPD
La Plata	LPG	La Plata	LPG
La Primavera	LPE	La Primavera	LPE
La Rochelle	LRH	Ile de Re	LRH
La Romana	LRM	Casa de Campo Intl	LRM
La Serena	LSC	La Florida	LSC
La Union	LUI	La Union	LUI
Lab Lab	LAB	Lab Lab	LAB
Labasa	LBS	Labasa	LBS
Labe	LEK	Tata	LEK
Labrea	LBR	Labrea	LBR
Labuan	LBU	Labuan	LBU
Labuan Bajo	LBJ	Komodo	LBJ
Labuha	LAH	Oesman Sadik	LAH
Laconia	LCI	Municipal	LCI
Lady Elliot Island	LYT	Lady Elliot Island	LYT
Ladysmith	LAY	Ladysmith	LAY
Lae	LAE	Nadzab	LAE
Lae Island	LML	Lae Island	LML
Lafayette	LAF	Purdue University	LAF
Lafayette	LFT	Regional	LFT
Lage	LCO	Lage	LCO
Lages	LAJ	Correia Pinto	LAJ
Laghouat	LOO	L'Mekrareg	LOO
Lago Agrio	LGQ	Lago Agrio	LGQ
Lagos	LOS	Murtala Muhammed Intl	LOS
Lagos de Moreno	LOM	F. Primo de Verdad	LOM
Lagunillas	LGY	Lagunillas	LGY
Lahad Datu	LDU	Lahad Datu	LDU
Lahore	LHE	Allama Iqbal Intl	LHE
Lahr	LHA	Black Forest	LHA
Lai	LTC	Lai	LTC
Laiagam	LGM	Laiagam	LGM
Lake Baringo	LBN	Lake Baringo	LBN
Lake Charles	LCH	Chennault Intl	CWF
Lake Charles	LCH	Regional	LCH
Lake City	LCQ	Lake City Gateway	LCQ
Lake Gregory	LGE	Mulan	LGE
Lake Manyara	LKY	Lake Manyara	LKY
Lake Minchumina	LMA	Lake Minchumina	LMA
Lake Murray	LMY	Lake Murray	LMY
Lake Nash	LNH	Lake Nash	LNH
Lake Placid	LKP	Lake Placid	LKP
Lake Turkana	LKU	Lake Turkana	LKU
Lakeba Island	LKB	Lakeba Island	LKB
Lakefield	LFP	Lakefield	LFP
Lakeland	LAL	Linder Regional	LAL
Lakeland Downs	LKD	Lakeland Downs	LKD
Lakeview	LKV	Lake County	LKV
Lakselv	LKL	Banak	LKL
Lalibela	LLI	Lalibela	LLI
Lamap	LPM	Malekoula	LPM
Lamar	LAA	Municipal	LAA
Lamassa	LMG	Lamassa	LMG
Lambarene	LBQ	Lambarene	LBQ
Lamen Bay	LNB	Lamen Bay	LNB
Lamerd	LFM	Lamerd	LFM
Lamidanda	LDN	Lamidanda	LDN
Lampang	LPT	Lampang	LPT
Lampedusa	LMP	Lampedusa	LMP
Lamu	LAU	Manda	LAU
Lanai City	LNY	Lanai City	LNY
Lancaster	LNS	Lancaster	LNS
Lander	LND	Hunt Field	LND
Landivisiau	LDV	Landivisiau	LDV
Land's End	LEQ	St Just	LEQ
Langeoog	LGO	Langeoog	LGO
Langgur	LUV	Dumatubun	LUV
Langimar	LNM	Langimar	LNM
Langkawi	LGK	International	LGK
Langtang	LTG	Langtang	LTG
Lankaran	LLK	Lankaran	LLK
Lannion	LAI	Lannion	LAI
Lansdowne Station	LDW	Lansdowne Station	LDW
Lansing	LAN	Capital Region Intl	LAN
Lanzhou	LHW	Zhongchuan	LHW
Laoag	LAO	International	LAO
Laohekou	LHK	Laohekou	LHK
LaPorte	LPO	Municipal	LPO
Lappeenranta	LPP	Lappeenranta	LPP
Lar	LRR	Lar	LRR
Laramie	LAR	Regional	LAR
Larantuka	LKA	Gewayantana	LKA
Laredo	LRD	International	LRD
Larisa	LRA	Thessalia	LRA
Larnaca	LCA	Larnaca	LCA
Las Cruces	LRU	International	LRU
Las Gaviotas	LGT	Las Gaviotas	LGT
Las Heras	LHS	Las Heras	LHS
Las Khoreh	LKR	Las Khoreh	LKR
Las Limas	LLH	Reginaldo Hammer	LLH
Las Lomitas	LLS	Alferez A. Rodriguez	LLS
Las Piedras	LSP	Josefa Camejo Intl	LSP
Las Vegas	LAS	Boulder City Municipal	BLD
Las Vegas	LAS	Henderson ExecutiveA	HSH
Las Vegas	LAS	Metropolitan Area	LAS
Las Vegas	LAS	McCarran International	LAS
Las Vegas	LAS	Nellis AFB	LSV
Las Vegas	LAS	North Las Vegas Arpt	VGT
Las Vegas	LVS	Municipal	LVS
Lashio	LSH	Lashio	LSH
Lastoursville	LTL	Lastoursville	LTL
Latacunga	LTX	Cotapaxi International	LTX
Latakia	LTK	Bassel al Assad Intl	LTK
Latrobe	LBE	Arnold Palmer Regional	LBE
Latrobe	LTB	Latrobe	LTB
Latur	LTU	Latur	LTU
Laucala Island	LUC	Laucala Island	LUC
Launceston	LST	Launceston	LST
Laura	LUU	Laura	LUU
Laurie River	LRQ	Laurie River	LRQ
Laval	LVA	Entrammes	LVA
Lavan Island	LVP	Lavan Island	LVP
Laverton	LVO	Laverton	LVO
Lawas	LWY	Lawas	LWY
Lawdar	LDR	Lawdar	LDR
Lawn Hill	LWH	Lawn Hill	LWH
Lawrence	LWC	Municipal	LWC
Lawrence	LWM	Municipal	LWM
Lawrenceville	LVL	Brunswick Municipal	LVL
Lawrenceville	LWV	Vincennes Intl	LWV
Lawrenceville	LZU	Gwinnett County	LZU
Lawton/Fort Sill	LAW	Henry Post AAF	FSI
Lawton/Fort Sill	LAW	Regional	LAW
Layang-Layang Island	LAC	Layang-Layang Island	LAC
Lazaro Cardenas	LZC	Lazaro Cardenas	LZC
Le Havre	LEH	Octeville	LEH
Le Mans	LME	Arnage	LME
Le Mars	LRJ	Municipal	LRJ
Le Puy	LPY	Loudes	LPY
Le Touquet-Paris-Plage	LTQ	Le Touquet-Paris-Plage	LTQ
Leadville	LXV	Lake County	LXV
Learmonth	LEA	Learmonth	LEA
Lebak	LWA	Lebak	LWA
Lebakeng	LEF	Lebakeng	LEF
Lebanon	LEB	Municipal	LEB
Lecce	LCC	Galatina	LCC
Leeds/Bradford	LBA	Airport	LBA
Leesburg	LEE	International	LEE
Leeuwarden	LWR	Air Base	LWR
Legaspi	LGP	Legaspi	LGP
Lehu	LHP	Lehu	LHP
Leigh Creek	LGH	Leigh Creek	LGH
Leinster	LER	Leinster	LER
Leipzig/Halle	LEJ	Airport	LEJ
Leitre	LTF	Leitre	LTF
Lekana	LKC	Lekana	LKC
Lekhwair	LKW	Lekhwair	LKW
Leknes	LKN	Leknes	LKN
Lekoni	LEO	Lekoni	LEO
Lelystad	LEY	Lelystad	LEY
Lemmon	LEM	Municipal	LEM
Lencois	LEC	Horacio de Mattos	LEC
Lengbati	LNC	Lengbati	LNC
Leon	LEN	Leon	LEN
Leonardtown	LTW	St Mary's County Rgnl	LTW
Leonora	LNO	Leonora	LNO
Leopoldina	LEP	Leopoldina	LEP
Lereh	LHI	Lereh	LHI
Leribe	LRB	Leribe	LRB
Leron Plains	LPN	Leron Plains	LPN
Leros	LRS	Leros	LRS
Les Sables-d'Olonne	LSO	Talmont	LSO
Lese	LNG	Lese	LNG
Leshukonskoye	LDG	Leshukonskoye	LDG
Lesobeng	LES	Lesobeng	LES
Lethem	LTM	Lethem	LTM
Leticia	LET	Alfredo V. Cobb Intl	LET
Letterkenny	LTR	Letterkenny	LTR
Levuka	LEV	Bureta	LEV
Lewisburg	LWB	Greenbrier Valley	LWB
Lewiston	LWS	Nez Perce County	LWS
Lewiston/Auburn	LEW	Municipal	LEW
Lewistown	LWT	Municipal	LWT
Lewoleba	LWE	Wunopito	LWE
Lexington	LEX	Metropolitan Area	LEX
Lexington	LEX	Blue Grass	LEX
Lexington	LXN	Jim Kelly Field	LXN
Lhasa/Lasa	LXA	Gonggar	LXA
Lhok Seumawe	LSW	Malikussaleh	LSW
Lhok Sukon	LSX	Lhok Sukon	LSX
Liangping	LIA	Liangping	LIA
Lianshulu	LHU	Lianshulu	LHU
Lianyungang	LYG	Baitabu	LYG
Libenge	LIE	Libenge	LIE
Liberal	LBL	Mid-America Regional	LBL
Liberia	LIR	D. Oduber Quiros Intl	LIR
Libo	LLB	Libo	LLB
Liboi	LBK	Liboi	LBK
Libreville	LBV	Leon M'ba Intl	LBV
Lidkoping	LDK	Hovby	LDK
Liege	LGG	Airport	LGG
Liepaja	LPX	International	LPX
Lifou	LIF	Ouanaham	LIF
Lightning Ridge	LHG	Lightning Ridge	LHG
Lihir Island	LNV	Kunaye	LNV
Lihue	LIH	Lihue	LIH
Lijiang	LJG	Sanyi	LJG
Likiep Island	LIK	Likiep Island	LIK
Likoma Island	LIX	Likoma Island	LIX
Lille	LIL	Lesquin	LIL
Lilongwe	LLW	Kamuzu Intl	LLW
Lima	LIM	Jorge Chavez Intl	LIM
Limbang	LMN	Limbang	LMN
Limbunya Station	LIB	Limbunya Station	LIB
Lime Acres	LMR	Finsch Mine	LMR
Lime Village	LVD	Lime Village	LVD
Limestone	LIZ	Loring Intl	LIZ
Limnos	LXS	Limnos	LXS
Limoges	LIG	Bellegarde	LIG
Limon	LIC	Municipal	LIC
Limon	LIO	International	LIO
Limon	LMH	Limon	LMH
Lincang	LNJ	Lincang	LNJ
Lincoln	LNK	Lincoln	LNK
Linda Downs	LLP	Linda Downs	LLP
Lindeman Island	LDC	Lindeman Island	LDC
Linden	LDJ	Linden	LDJ
Lindi	LDI	Kikwetu	LDI
Linfen	LFQ	Qiaoli	LFQ
Linga Linga	LGN	Linga Linga	LGN
Linkoping	LPI	City Airport	LPI
Lins	LIP	Lucas Nogueira Garcez	LIP
Linyi	LYI	Shubuling	LYI
Linz	LNZ	Blue Danube	LNZ
Lipetsk	LPK	Lipetsk	LPK
Lisala	LIQ	Lisala	LIQ
Lisbon	LIS	Airport	LIS
Lismore	LSY	Lismore	LSY
Lissadell	LLL	Lissadell	LLL
Little Cayman	LYB	Edward Bodden	LYB
Little Rock	LIT	B. & H. Clinton Natl	LIT
Liupanshui	LPF	Yue Zhao	LPF
Liuzhou	LZH	Bailian	LZH
Livengood	LIV	Livengood Camp	LIV
Livermore	LVK	Municipal	LVK
Liverpool	LPL	John Lennon	LPL
Livingston	LVM	Mission Field	LVM
Livingstone	LVI	Livingstone	LVI
Lizard Island	LZR	Lizard Island	LZR
Ljubljana	LJU	Joze Pucnik	LJU
Loani	LNQ	Loani	LNQ
Lobatse	LOQ	Lobatse	LOQ
Lobito	LLT	Lobito	LLT
Lock	LOC	Lock	LOC
Lock Haven	LHV	W T Piper Memorial	LHV
Lodja	LJA	Lodja	LJA
Lodwar	LOK	Lodwar	LOK
Lodz	LCJ	Wladyslaw Reymont	LCJ
Loei	LOE	Loei	LOE
Loen Island	LOF	Loen Island	LOF
Logan	LGU	Logan-Cache	LGU
Loikaw	LIW	Loikaw	LIW
Loja	LOH	Catamayo	LOH
Lokichogio	LKG	Lokichogio	LKG
Lome	LFW	G. Eyadema Intl	LFW
Lompoc	LPC	Metropolitan Area	LPC
Lompoc	LPC	Lompoc Apt	LPC
Lompoc	LPC	Vandenberg AFB	VBG
Loncopue	LCP	Loncopue	LCP
Londolozi	LDZ	Londolozi	LDZ
London	LON	Biggin Hill	BQH
London	LON	City Airport	LCY
London	LON	Gatwick	LGW
London	LON	Heathrow	LHR
London	LON	Metropolitan Area	LON
London	LON	Luton	LTN
London	LON	Southend	SEN
London	LON	Stansted	STN
London/Corbin	LOZ	Magee Field	LOZ
Londrina	LDB	Jose Richa	LDB
Lone Rock	LNR	Tri-County Regional	LNR
Lonely	LNI	Air Station	LNI
Long Akah	LKH	Long Akah	LKH
Long Apung	LPU	Long Apung	LPU
Long Banga	LBP	Long Banga	LBP
Long Bawan	LBW	Yuvai Semaring	LBW
Long Beach	LGB	Daugherty Field	LGB
Long Island	LSJ	Long Island	LSJ
Long Lellang	LGL	Long Lellang	LGL
Long Semado	LSM	Long Semado	LSM
Long Sukang	LSU	Long Sukang	LSU
Longana	LOD	Longana	LOD
Longreach	LRE	Longreach	LRE
Longyan	LCX	Guanzhishan	LCX
Longyearbyen	LYR	Svalbard	LYR
Lonorore	LNE	Lonorore	LNE
Lontras	LOI	Helmuth Baungartem	LOI
Lopez Island	LPS	Lopez Island	LPS
Loralai	LRG	Loralai	LRG
Lord Howe Island	LDH	Lord Howe Island	LDH
Lordsburg	LSB	Municipal	LSB
Loreto	LTO	International	LTO
Lorica	LRI	Lorica	LRI
Lorient	LRT	Lann Bihoue	LRT
Lorraine	LOA	Lorraine	LOA
Los Alamos	LAM	Los Alamos	LAM
Los Andes	LOB	San Rafael	LOB
Los Angeles	LAX	Metropolitan Area	LAX
Los Angeles	LAX	International	LAX
Los Angeles	LAX	Van Nuys	VNY
Los Angeles	LAX	Whiteman	WHP
Los Angeles	LSQ	Maria Dolores	LSQ
Los Banos	LSN	Municipal	LSN
Los Chiles	LSL	Los Chiles	LSL
Los Menucos	LMD	Los Menucos	LMD
Los Mochis	LMM	Fed. Valle del Fuerte	LMM
Los Pijiguaos	LPJ	Armando Schwarck	LPJ
Los Roques	LRV	Los Roques	LRV
Los Tablones	LOX	Los Tablones	LOX
Lossiemouth	LMO	RAF Station	LMO
Lotus Vale Station	LTV	Lotus Vale Station	LTV
Louis Trichardt	LCD	Louis Trichardt	LCD
Louisa	LOW	Louisa Co.-Freeman Fld	LOW
Louisburg	LFN	Triangle North Exec.	LFN
Louisville	LMS	Winston County	LMS
Louisville	SDF	Bowman Field	LOU
Lourdes/Tarbes	LDE	Pyrenees	LDE
Lovelock	LOL	Derby Field	LOL
Lowai	LWI	Lowai	LWI
Loyengalani	LOY	Loyengalani	LOY
Luabo	LBM	Luabo	LBM
Luanda	LAD	4 de Fevereiro	LAD
Luang Namtha	LXG	Luang Namtha	LXG
Luang Prabang	LPQ	International	LPQ
Lubang	LBX	Lubang	LBX
Lubbock	LBB	Metropolitan Area	LBB
Lubbock	LBB	Preston Smith Intl	LBB
Lubbock	LBB	Reese Airpark	REE
Lublin	LUZ	Lublin	LUZ
Lucapa	LBZ	Lucapa	LBZ
Lucas do Rio Verde	LVR	Bom Futuro	LVR
Lucca	LCV	Tassignano	LCV
Lucenec	LUE	Lucenec	LUE
Lucknow	LKO	Chaudhary Charan Singh	LKO
Luderitz	LUD	Luderitz	LUD
Ludhiana	LUH	Ludhiana	LUH
Ludington	LDM	Mason County	LDM
Luena	LUO	Luena	LUO
Lufkin	LFK	Angelina County	LFK
Lugano	LUG	Agno	LUG
Lugh Ganane	LGX	Lugh Ganane	LGX
Luiza	LZA	Luiza	LZA
Lukla	LUA	Tenzing-Hillary	LUA
Lukulu	LXU	Lukulu	LXU
Lulea	LLA	Kallax	LLA
Luliang	LLV	Luliang	LLV
Lumberton	LBT	Municipal	LBT
Lumbo	LFB	Lumbo	LFB
Lumi	LMI	Lumi	LMI
Lumidpau	LUB	Lumidpau	LUB
Luoyang	LYA	Beijiao	LYA
Luozi	LZI	Luozi	LZI
Lusaka	LUN	International	LUN
Lusambo	LBO	Lusambo	LBO
Lusanga	LUS	Lusanga	LUS
Lusk	LSK	Municipal	LSK
Luwuk	LUW	S.Aminuddin Amir	LUW
Luxembourg	LUX	Luxembourg	LUX
Luxor	LXR	International	LXR
Luzamba	LZM	Luzamba	LZM
Luzhou	LZO	Lantian	LZO
Lviv	LWO	International	LWO
Lycksele	LYC	Lycksele	LYC
Lydd	LYX	London Ashford	LYX
Lynchburg	LYH	Regional-P. Glenn Fld	LYH
Lyndhurst Station	LTP	Lyndhurst Station	LTP
Lyndonville	LLX	Lyndonville	LLX
Lyneham	LYE	RAF Station	LYE
Lyon	LYS	Grenoble-St Geoirs	GNB
Lyon	LYS	Bron	LYN
Lyon	LYS	Metropolitan Area	LYS
Lyon	LYS	St-Exupery	LYS
Lyons	LYO	Rice County Municipal	LYO
Malargue	LGS	Comodoro D.R. Salomon	LGS
Malda	LDA	Malda	LDA
Malelane	LLE	Malelane	LLE
Mali Losinj	LSZ	Mali Losinj	LSZ
Mangshi	LUM	Dehong Mangshi	LUM
Marsa Brega	LMQ	Marsa Brega	LMQ
Matsu (Nangan)	LZN	Matsu (Nangan)	LZN
Milan	MIL	Linate	LIN
Monclova	LOV	V.Carranza Intl	LOV
Mount Holly	LLY	South Jersey Regional	LLY
Mulia	LII	Mulia	LII
Munbil	LNF	Munbil	LNF
New Laura	LUT	New Laura	LUT
New York	NYC	LaGuardia	LGA
Niamtougou	LRL	International	LRL
North Platte	LBF	Regional(Lee Bird Fld)	LBF
Nyingchi/Linzhi	LZY	Mainling/Milin	LZY
Palma	LMZ	Palma	LMZ
Palopo	LLO	Lagaligo	LLO
Paris	PAR	Le Bourget	LBG
Phoenix	PHX	Luke AFB	LUF
Pickens	LQK	Pickens	LQK
Pinar del Rio	LCL	La Coloma	LCL
Pontes e Lacerda	LCB	Pontes e Lacerda	LCB
Praya	LOP	Lombok International	LOP
Puerto Leguizamo	LQM	Caucaya	LQM
Qalah-ye Now	LQN	Qalah-ye Now	LQN
Rio Dulce	LCF	Las Vegas	LCF
Romeoville	LOT	Lewis University	LOT
Salima	LMB	Salima	LMB
San Luis	LUQ	D. Cesar Raul Ojeda	LUQ
Santana do Livramento	LVB	Santana do Livramento	LVB
Seattle	SEA	Lake Union SPB	LKE
Seo de Urgel	LEU	Seo de Urgel	LEU
Shetland Islands	SDZ	Sumburgh	LSI
Shetland Islands	SDZ	Lerwick/Tingwall	LWK
Smolensk	LNX	Smolensk	LNX
St Petersburg	LED	Metropolitan Area	LED
St Petersburg	LED	Pulkovo	LED
St Petersburg	LED	Rzhevka	RVH
St-Laurent du Maroni	LDX	St-Laurent du Maroni	LDX
St-Tropez	LTT	La Mole	LTT
Sumbawa	SWQ	Lunyuk	LYK
Sydney	SYD	Palm Beach SPB	LBH
Terre-de-Haut	LSS	Les Saintes	LSS
Tzaneen	LTA	Tzaneen	LTA
Wells	LWL	Municipal-Harriet Fld	LWL
West Palm Beach	PBI	Palm Beach County Park	LNA
Willoughby	LNN	Lost Nation Municipal	LNN
Wise	LNP	Lonesome Pine	LNP
Yichun(Heilongjiang)	LDS	Lindu	LDS
Yongzhou	LLF	Lingling	LLF
Yuma	YUM	Laguna AAF	LGF

Displaying 484 result(s)