Search results for "N"
CITY NAME	3-LETTER CITY CODE	AIRPORT NAME	3-LETTER AIRPORT CODE
Afton	NRI	Grand Lake Regional	NRI
Al Najaf	NJF	Al-Ashraf Intl	NJF
Anegada	NGD	Auguste George	NGD
Ankokoambo	NKO	Ankokoambo	NKO
Annai	NAI	Annai	NAI
Annecy	NCY	Meythet	NCY
Annobon	NBN	Annobon	NBN
Arcata/Eureka	ACV	Kneeland	NLN
Atsugi	NJA	NAF	NJA
Bagan/Nyaung-u	NYU	Bagan/Nyaung-u	NYU
Baishan	NBS	Changbaishan	NBS
Banaina	NAF	Banaina	NAF
Banda Island	NDA	Bandaneira	NDA
Barranco Minas	NBB	Barranco Minas	NBB
Beckwourth	NVN	Nervino	NVN
Beeville	NIR	Chase Field Industrial	NIR
Beijing	BJS	Nanyuan	NAY
Bimini	BIM	North Seaplane Base	NSB
Bintuni	NTI	Stenkol	NTI
Brunswick	NHZ	Executive	NHZ
Ceiba	NRR	J. Aponte de la Torre	NRR
Chenega	NCN	Chenega Bay	NCN
Corpus Christi	CRP	NAS (Truax Field)	NGP
Corpus Christi	CRP	Cabaniss Field NOLF	NGW
Crows Landing	NRC	Crows Landing	NRC
Daman	NMB	Daman	NMB
Darnley Island	NLF	Darnley Island	NLF
Dubai	DXB	Minhad AB	NHD
Duesseldorf	DUS	Weeze	NRN
En Nahud	NUD	En Nahud	NUD
Enfidha	NBE	Hammamet	NBE
Fallon	NFL	Municipal	FLX
Fallon	NFL	Metropolitan Area	NFL
Fallon	NFL	NAS-Van Voorhis Field	NFL
Foley	NHX	Barin NOLF	NHX
Fort McMurray	YMM	Mildred Lake	NML
Gau Island	NGI	Gau Island	NGI
Guantanamo	GAO	Mariana Grajales	NBW
Hatton	NUF	Castlereigh Resrvr SPB	NUF
Huambo	NOV	Albano Machado	NOV
Imperial Beach	NRS	NOLF (Ream Field)	NRS
Imperial/El Centro	IPL	El Centro NAF	NJK
Jacksonville	JAX	Whitehouse NOLF	NEN
Jacksonville	JAX	NAS (Towers Field)	NIP
Kaneohe	NGF	Kaneohe Bay MCAS	NGF
Kenitra	NNA	Royal AFB	NNA
Key West	EYW	NAS (Boca Chica Field)	NQX
Kingsville	NQI	NAS	NQI
Kinshasa	FIH	N'dolo	NLO
Knock	NOC	Ireland West	NOC
Kolo	NKL	Fuma	NKL
Lakehurst	NEL	Maxfield Field	NEL
Lemoore	NLC	NAS (Reeves Field)	NLC
Macanal	NAD	Macanal	NAD
Manang	NGX	Manang	NGX
Mandera	NDE	Mandera	NDE
Manti/Ephraim	NTJ	Manti/Ephraim	NTJ
Manzhouli	NZH	Xijiao	NZH
Mayport	NRB	Naval Station	NRB
Mendi	NDM	Masslo	NDM
Mexico City	MEX	Santa Lucia AFB	NLU
Millington	NQA	Regional Jetport	NQA
Milton	NSE	Whiting Fild NAS North	NSE
Miracema do Tocantins	NTM	Miracema do Tocantins	NTM
Moheli	NWA	Bandar es Salam	NWA
Monterrey	MTY	Del Norte Intl	NTR
Monywa	NYW	Monywa	NYW
Mountain View	NUQ	Moffett Federal Airfld	NUQ
Mykolaiv	NLV	International	NLV
Nabire	NBX	Nabire	NBX
Nachingwea	NCH	Nachingwea	NCH
Nadi	NAN	International	NAN
Nador	NDR	El Aroui	NDR
Nadunumu	NDN	Nadunumu	NDN
Nadym	NYM	Nadym	NYM
Nafoora	NFR	Nafoora	NFR
Nagasaki	NGS	Nagasaki Airport	NGS
Nagasaki	NGS	Omura	OMJ
Nagoya	NGO	Metropolitan Area	NGO
Nagoya	NGO	Chubu Centrair Intl	NGO
Nagoya	NGO	Nagoya (Komaki)	NKM
Nagpur	NAG	Dr.Ambedkar Intl	NAG
Nairobi	NBO	Metropolitan Area	NBO
Nairobi	NBO	Jomo Kenyatta Intl	NBO
Nairobi	NBO	Wilson	WIL
Nakchivan	NAJ	Nakchivan	NAJ
Nakhon Ratchasima	NAK	Nakhon Ratchasima	NAK
Nakhon Si Thammarat	NST	Nakhon Si Thammarat	NST
Naknek	NNK	Naknek	NNK
Nakuru	NUU	Nakuru	NUU
Nalchik	NAL	Nalchik	NAL
Namangan	NMA	Namangan	NMA
Nambaiyufa	NBA	Nambaiyufa	NBA
Nambucca	NBH	Nambucca	NBH
Namdrik Island	NDK	Namdrik Island	NDK
Namlea	NAM	Namlea	NAM
Namrole	NRE	Namrole	NRE
Namtu	NMT	Namtu	NMT
Namudi	NDI	Namudi	NDI
Namutoni	NNI	Namutoni	NNI
Nan	NNT	Nan	NNT
Nanchong	NAO	Gaoping	NAO
Nanded	NDC	Nanded	NDC
Nangade	NND	Nangade	NND
Nangapinoh	NPO	Nangapinoh	NPO
Nanjing	NKG	Lukou Intl	NKG
Nankina	NKN	Nankina	NKN
Nanning	NNG	Wuxu Intl	NNG
Nansang	NMS	Nansang	NMS
Nantes	NTE	Atlantique	NTE
Nantong	NTG	Xingdong	NTG
Nanuque	NNU	Nanuque	NNU
Nanyang	NNY	Jiangying	NNY
Nanyuki	NYK	Nanyuki	NYK
Naoro	NOO	Naoro	NOO
Napier/Hastings	NPE	Hawke's Bay	NPE
Naples	NAP	Capodichino	NAP
Nappa Merrie	NMR	Nappa Merrie	NMR
Napperby	NPP	Napperby	NPP
Napuka	NAU	Napuka	NAU
Nara	NRM	Keibane	NRM
Naracoorte	NAC	Naracoorte	NAC
Narathiwat	NAW	Narathiwat	NAW
Nargana	NGN	Nargana	NGN
Narrabri	NAA	Narrabri	NAA
Narrandera	NRA	Narrandera	NRA
Narrogin	NRG	Narrogin	NRG
Narvik	NVK	Framnes	NVK
Naryan-Mar	NNM	Naryan-Mar	NNM
Nassau	NAS	Lynden Pindling Intl	NAS
Natadola	NTA	Natadola	NTA
Natal	NAT	International	NAT
Natitingou	NAE	Natitingou	NAE
Natuna	NTX	Ranai	NTX
Naukiti Bay	NKI	Sea Plane Base	NKI
Navegantes	NVT	Victor Konder Intl	NVT
Navoi	NVI	International	NVI
Nay Pyi Taw	NYT	International	NYT
Nazca	NZC	Maria Reiche Neuman	NZC
N'dalatando	NDF	N'dalatando	NDF
Ndele	NDL	Ndele	NDL
N'Djamena	NDJ	Hassan Djamous Intl	NDJ
Ndola	NLA	Ndola	NLA
Necochea	NEC	Necochea	NEC
Necocli	NCI	Necocli	NCI
Neftekamsk	NEF	Neftekamsk	NEF
Nefteyugansk	NFG	Nefteyugansk	NFG
Negril	NEG	Negril	NEG
Neiva	NVA	Benito Salas	NVA
Nejo	NEJ	Nejo	NEJ
Nekemte	NEK	Nekemte	NEK
Nelson	NSN	Nelson	NSN
Nelson Lagoon	NLG	Nelson Lagoon	NLG
Nelspruit	NLP	Kruger Mpumalanga Intl	MQP
Nelspruit	NLP	Nelspruit Airport	NLP
Nephi	NPH	Municipal	NPH
Neryungri	NER	Chulman	NER
Neuquen	NQN	Presidente Peron	NQN
Nevada	NVD	Municipal	NVD
Nevers	NVS	Fourchambault	NVS
Nevis	NEV	Vance W. Amory Intl	NEV
Nevsehir	NAV	Kapadokya	NAV
New Halfa	NHF	New Halfa	NHF
New Moon	NMP	New Moon	NMP
New Orleans	MSY	NAS JRB/A.Callender	NBG
New Orleans	MSY	Lakefront	NEW
New Plymouth	NPL	New Plymouth	NPL
New York	NYC	Newark Liberty Intl	EWR
New York	NYC	John F Kennedy Intl	JFK
New York	NYC	LaGuardia	LGA
New York	NYC	Metropolitan Area	NYC
New York	NYC	Stewart International	SWF
Newcastle	NCL	International	NCL
Newcastle	NCS	Newcastle	NCS
Newcastle	NTL	Aeropelican	BEO
Newcastle	NTL	Metropolitan Area	NTL
Newcastle	NTL	Williamtown	NTL
Newport	NPT	State	NPT
Newport	NWH	Parlin Field	NWH
Newquay	NQY	Cornwall	NQY
Newry	NRY	Newry	NRY
Neyveli	NVY	Neyveli	NVY
Ngala	NGL	Ngala	NGL
Ngaoundere	NGE	Ngaoundere	NGE
Nha Trang	NHA	Cam Ranh Intl	CXR
Nha Trang	NHA	Metropolitan Area	NHA
Nha Trang	NHA	Air Base	NHA
Niamey	NIM	Diori Hamani Intl	NIM
Niau	NIU	Niau	NIU
Nice	NCE	Cote d'Azur	NCE
Nicholson	NLS	Nicholson	NLS
Nicosia	NIC	Nicosia	NIC
Nicoya	NCT	Nicoya	NCT
Nifty	NIF	Nifty	NIF
Nightmute	NME	Nightmute	NME
Nikolai	NIB	Nikolai	NIB
Nikolayevsk-na-Amure	NLI	Nikolayevsk-na-Amure	NLI
Nikunau	NIG	Nikunau	NIG
Niles	NLE	Jerry Tyler Memorial	NLE
Nimba	NIA	Nimba	NIA
Ningbo	NGB	Lishe Intl	NGB
Ningerum	NGR	Ningerum	NGR
Ninglang	NLH	Luguhu	NLH
Ninilchik	NIN	Ninilchik	NIN
Nioki	NIO	Nioki	NIO
Niokolo-Koba	NIK	Niokolo-Koba	NIK
Nioro du Sahel	NIX	Nioro du Sahel	NIX
Niort	NIT	Souche	NIT
Nipa	NPG	Nipa	NPG
Niquelandia	NQL	Niquelandia	NQL
Niuafo'ou	NFO	Mata'aho	NFO
Niuatoputapu	NTT	Kuini Lavenia	NTT
Nizhnekamsk	NBC	Begishevo	NBC
Nizhnevartovsk	NJC	Nizhnevartovsk	NJC
Nkan	NKA	Nkan	NKA
Nkau	NKU	Nkau	NKU
N'kayi	NKY	Yokangassi	NKY
Nkongsamba	NKS	Nkongsamba	NKS
Nogales	NOG	International	NOG
Nogeh	NUJ	Nogeh	NUJ
Nogliki	NGK	Nogliki	NGK
Nomad River	NOM	Nomad River	NOM
Nomane	NMN	Nomane	NMN
Nondalton	NNL	Nondalton	NNL
Nonouti	NON	Nonouti	NON
Noonkanbah	NKB	Noonkanbah	NKB
Noosaville	NSV	Noosa	NSV
Norden	NOD	Norddeich	NOD
Norderney	NRD	Norderney	NRD
Nordfjordur	NOR	Nordfjordur	NOR
Norfolk	ORF	NS (Chambers Field)	NGU
Norfolk Island	NLK	Norfolk Island	NLK
Norilsk	NSK	Alykel	NSK
Norman's Cay	NMC	Norman's Cay	NMC
Normanton	NTN	Normanton	NTN
Norrkoping	NRK	Kungsangen	NRK
Norseman	NSM	Norseman	NSM
Norsup	NUS	Norsup	NUS
North Caicos	NCA	North Caicos	NCA
North Kingdom	NCO	Quonset State	NCO
North Ronaldsay	NRL	North Ronaldsay	NRL
Northolt	NHT	RAF Station	NHT
Norwich	NWI	International	NWI
Nosara	NOB	Nosara	NOB
Nosy-Be	NOS	Fascene	NOS
Notodden	NTB	Notodden	NTB
Nottingham	NQT	East Midlands	EMA
Nottingham	NQT	Metropolitan Area	NQT
Nottingham	NQT	Nottingham Airport	NQT
Nouadhibou	NDB	Nouadhibou	NDB
Nouakchott	NKC	Nouakchott	NKC
Noumea	NOU	Magenta	GEA
Noumea	NOU	Metropolitan Area	NOU
Noumea	NOU	La Tontouta	NOU
Nova Xavantina	NOK	Nova Xavantina	NOK
Novato	NOT	Marin County	NOT
Novgorod	NVR	Novgorod	NVR
Novo Aripuana	NVP	Novo Aripuana	NVP
Novo Progresso	NPR	Novo Progresso	NPR
Novokuznetsk	NOZ	Spichenkovo	NOZ
Novorossiysk	NOI	Krymska	NOI
Novy Urengoy	NUX	Novy Urengoy	NUX
Now Shahr	NSH	Now Shahr	NSH
Nowata	NWT	Nowata	NWT
Nowra	NOA	Nowra	NOA
Noyabrsk	NOJ	Noyabrsk	NOJ
Nueva Guinea	NVG	Nueva Guinea	NVG
Nuevo Casas Grandes	NCG	Nuevo Casas Grandes	NCG
Nuevo Laredo	NLD	Quetzalcoatl Intl	NLD
Nuguria Islands	NUG	Nuguria Islands	NUG
Nuiqsut	NUI	Nuiqsut	NUI
Nuku Hiva	NHV	Nuku Hiva	NHV
Nukus	NCU	Nukus	NCU
Nukutavake	NUK	Nukutavake	NUK
Nukutepipi	NKP	Nukutepipi	NKP
Nulato	NUL	Nulato	NUL
Nullagine	NLL	Nullagine	NLL
Nullarbor	NUR	Nullarbor Motel	NUR
Numbulwar	NUB	Numbulwar	NUB
Nunapitchuk	NUP	Nunapitchuk	NUP
Nunchia	NUH	Nunchia	NUH
Nunukan	NNX	Nunukan	NNX
Nuqui	NQU	Reyes Murillo	NQU
Nuremberg	NUE	Airport	NUE
Nushki	NHS	Nushki	NHS
Nutuve	NUT	Nutuve	NUT
Nuwara Eliya	NUA	Gregory Lake SPB	NUA
Nyagan	NYA	Nyagan	NYA
Nyeri	NYE	Nyeri	NYE
Nyngan	NYN	Nyngan	NYN
Nyurba	NYR	Nyurba	NYR
Nzagi	NZA	Nzagi	NZA
Nzerekore	NZE	Nzerekore	NZE
Oak Harbor	ODW	Whidbey Island NAS	NUW
Patuxent River	NHK	NAS (Trapnell Field)	NHK
Pensacola	PNS	NAS (F.Sherman Field)	NPA
Pensacola	PNS	Saufley Field NOLF	NUN
Port Mugu	NTD	NAS	NTD
Puerto Nare	NAR	Puerto Nare	NAR
Qaanaaq	NAQ	Qaanaaq	NAQ
Qiqihar	NDG	Sanjiazi	NDG
Quantico	NYG	MCAF (Turner Field)	NYG
Rundu	NDU	Rundu	NDU
Sam Neua	NEU	Sam Neua	NEU
San Blas	NBL	Wannukandi	NBL
San Carlos	NCR	San Carlos	NCR
San Diego	SAN	Miramar MCAS	NKX
San Diego	SAN	North Island NAS	NZY
San Miguel	NMG	San Miguel	NMG
San Pedro de Uraba	NPU	San Pedro de Uraba	NPU
Sanday	NDY	Sanday	NDY
Sandstone	NDS	Sandstone	NDS
Santa Ana Island	NNB	Santa Ana Island	NNB
Santa Carolina	NTC	Santa Carolina	NTC
Santo Antao Island	NTO	Agostinho Neto	NTO
Scone	NSO	Scone	NSO
Shiquanhe	NGQ	Ngari Gunsa/Ali Kunsha	NGQ
Sigonella	NSY	NAS	NSY
Simberi Island	NIS	Simberi Island	NIS
Sinak	NKD	Sinak	NKD
Sinop	NOP	Sinop	NOP
Sirnak	NKT	Sirnak	NKT
Slayton	NSL	Municipal	NSL
Spiddal	NNR	Connemara	NNR
Star Harbour	NAZ	Nana	NAZ
Stockholm	STO	Skavsta	NYO
Sumbe	NDD	Sumbe	NDD
Sun City	NTY	Pilanesberg Intl	NTY
Sunchales	NCJ	Sunchales	NCJ
Sunyani	NYI	Sunyani	NYI
Tahuna	NAH	Naha	NAH
Tokyo	TYO	Narita Intl	NRT
Virginia Beach	NTU	Oceana NAS	NTU
Wajima	NTQ	Noto	NTQ
Xinyuan	NLT	Nalati	NLT
Yaounde	YAO	Nsimalen Intl	NSI
Young	NGA	Young	NGA
Zhalantun	NZL	Chengjisihan	NZL

Displaying 338 result(s)