Search results for "O"
CITY NAME	3-LETTER CITY CODE	AIRPORT NAME	3-LETTER AIRPORT CODE
Abengourou	OGO	Abengourou	OGO
Anacortes	OTS	Anacortes	OTS
Are/Ostersund	OSD	Are/Ostersund	OSD
Asturias	OVD	Asturias	OVD
Aubenas	OBS	Ardeche Meridionale	OBS
Bagram	OAI	Bagram	OAI
Balimo	OPU	Balimo	OPU
Batouri	OUR	Batouri	OUR
Bekily	OVA	Bekily	OVA
Bissau	OXB	Osvaldo Vieira Intl	OXB
Bodaybo	ODO	Bodaybo	ODO
Bol	OTC	Berim	OTC
Bongor	OGR	Bongor	OGR
Boolgeeda	OCM	Boolgeeda	OCM
Bousso	OUT	Bousso	OUT
Boutilimit	OTL	Boutilimit	OTL
Bucharest	BUH	Henri Coanda	OTP
Cacoal	OAL	Capital do Cafe	OAL
Camp Bastion	OAZ	Camp Bastion	OAZ
Chicago	CHI	O'Hare International	ORD
Coca	OCC	Francisco de Orellana	OCC
Colon	ONX	Enrique Adolfo Jimenez	ONX
Columbus	CMH	Ohio State University	OSU
Columbus	OLU	Municipal	OLU
Contadora Island	OTD	Contadora Island	OTD
Cooma	OOM	Snowy Mountains	OOM
Cordillo Downs	ODL	Cordillo Downs	ODL
Cordoba	ODB	Airport	ODB
Corisco Island	OCS	Corisco Island	OCS
Cork	ORK	International	ORK
Coto 47	OTR	Coto 47	OTR
Cotriguacu	OTT	Andre Maggi	OTT
Fort Rucker/Ozark	OZR	Metropolitan Area	OZR
Fort Rucker/Ozark	OZR	Cairns AAF	OZR
Fraser Island	OKB	Orchid Beach	OKB
Fuerte Olimpo	OLK	Fuerte Olimpo	OLK
Georgetown	GEO	Ogle	OGL
Gold Coast	OOL	Coolangatta	OOL
Goya	OYA	Goya	OYA
Jacksonville	OAJ	Albert J Ellis	OAJ
Kahului	OGG	Kahului	OGG
Kansas City	MKC	Johnson Co Executive	OJC
Key Largo	OCA	Ocean Reef Club	OCA
Kobuk	OBU	Kobuk	OBU
Kohat	OHT	Kohat	OHT
Kokomo	OKK	Municipal	OKK
Kopasker	OPA	Kopasker	OPA
Kosciusko	OSX	Attala County	OSX
Koszalin	OSZ	Zegrze Pomorskie AB	OSZ
Kotzebue	OTZ	Ralph Wien Memorial	OTZ
Long Seridan	ODN	Long Seridan	ODN
Mafraq	OMF	King Hussein	OMF
Marmul	OMM	Marmul	OMM
Miami	MIA	Opa-locka Executive	OPF
Moanamani	ONI	Moanamani	ONI
Mohe	OHE	Gulian	OHE
Mokuti Lodge	OKU	Mokuti Lodge	OKU
Monkira	ONR	Monkira	ONR
Monterey/Carmel	MRY	Marina Municipal	OAR
Mooraberree	OOR	Mooraberree	OOR
Moramanga	OHB	Ambohibary	OHB
Morney	OXY	Morney	OXY
Mornington Island	ONG	Mornington Island	ONG
Morobe	OBM	Morobe	OBM
Moron	OZP	Air Base	OZP
Morotai Island	OTI	Pitu	OTI
Mostar	OMO	International	OMO
Mosul	OSM	International	OSM
Mota	OTA	Mota	OTA
Moyale	OYL	Moyale	OYL
Moyo	OYG	Moyo	OYG
Muang Xay	ODY	Oudomxai	ODY
Nacogdoches	OCH	A.L. Mangham Jr. Rgnl	OCH
Nagasaki	NGS	Omura	OMJ
Namsos	OSY	Namsos	OSY
Newport	ONP	Municipal	ONP
Nogales	OLS	International	OLS
Nome	OME	Nome	OME
Noorvik	ORV	R. (Bob) Curtis Mem.	ORV
Norfolk	OFK	Regional	OFK
Norfolk	ORF	NS (Chambers Field)	NGU
Norfolk	ORF	Metropolitan Area	ORF
Norfolk	ORF	International	ORF
Norman	OUN	Max Westheimer	OUN
Norridgewock	OWK	Central Maine	OWK
North Bend	OTH	Southwest Oregon Rgnl	OTH
Northampton	ORM	Sywell	ORM
Northway	ORT	Northway	ORT
Norwich	OIC	Lt. Warren Eaton	OIC
Norwood	OWD	Memorial	OWD
Novosibirsk	OVB	Tolmachevo	OVB
Oak Harbor	ODW	Whidbey Island NAS	NUW
Oak Harbor	ODW	A.J. Eisenberg	ODW
Oakdale	ODC	Oakdale	ODC
Oakey	OKY	Army Aviation Centre	OKY
Oakham	OKH	Cottesmore RAF	OKH
Oakland	OAK	Metropolitan Area	OAK
Oakland	OAK	International	OAK
Oakland	ODM	Garrett County	ODM
Oaktown	OTN	Ed-Air	OTN
Oamaru	OAM	Oamaru	OAM
Oaxaca	OAX	Xoxocotlan Intl	OAX
Oban	OBA	Oban	OBA
Oban	OBN	North Connel	OBN
Obano	OBD	Obano	OBD
Oberpfaffenhofen	OBF	Oberpfaffenhofen	OBF
Obidos	OBI	Obidos	OBI
Obihiro	OBO	Obihiro	OBO
Obo	OBX	Obo	OBX
Obock	OBC	Obock	OBC
Ocala	OCF	Intl (Jim Taylor Fld)	OCF
Ocana	OCV	Aguas Claras	OCV
Oceanside	OCN	Municipal	OCN
Ocho Rios	OCJ	Ian Fleming Intl	OCJ
Odate/Noshiro	ONJ	Odate/Noshiro	ONJ
Odense	ODE	Airport	ODE
Odesa	ODS	International	ODS
Odiham	ODH	RAF Station	ODH
Oecussi	OEC	Oecussi	OEC
Oenpelli	OPI	Oenpelli	OPI
Ofu Island	OFU	Ofu Island	OFU
Ogallala	OGA	Searle Field	OGA
Ogden	OGD	Hill AFB	HIF
Ogden	OGD	Metropolitan Area	OGD
Ogden	OGD	Hinckley	OGD
Ogdensburg	OGS	International	OGS
Ogeramnang	OGE	Ogeramnang	OGE
Ohakea	OHA	RNZAF Base	OHA
Ohrid	OHD	St.Paul the Apostle	OHD
Oiapoque	OYK	Oiapoque	OYK
Oita	OIT	Oita	OIT
Okaba	OKQ	Okaba	OKQ
Okao	OKV	Okao	OKV
Okaukuejo	OKF	Okaukuejo	OKF
Okayama	OKJ	Okayama	OKJ
Okeechobee	OBE	Okeechobee County	OBE
Okha	OHH	Novostroyka	OHH
Okhotsk	OHO	Okhotsk	OHO
Oki	OKI	Oki	OKI
Okierabu	OKE	Okierabu	OKE
Okinawa	OKA	Kadena AB	DNA
Okinawa	OKA	Metropolitan Area	OKA
Okinawa	OKA	Naha	OKA
Oklahoma City	OKC	Metropolitan Area	OKC
Oklahoma City	OKC	Will Rogers World	OKC
Oklahoma City	OKC	Wiley Post	PWA
Oklahoma City	OKC	Tinker AFB	TIK
Okmulgee	OKM	Regional	OKM
Okondja	OKN	Okondja	OKN
Okoyo	OKG	Okoyo	OKG
Oksapmin	OKP	Oksapmin	OKP
Oksibil	OKL	Gunung Bintang	OKL
Oktiabrsky	OKT	Oktiabrsky	OKT
Okushiri	OIR	Okushiri	OIR
Olafsfjordur	OFJ	Olafsfjordur	OFJ
Olafsvik	OLI	Rif	OLI
Olanchito	OAN	El Arrayan	OAN
Olavarria	OVR	Olavarria	OVR
Olbia	OLB	Costa Smeralda	OLB
Old Harbor	OLH	Old Harbor	OLH
Old Town	OLD	Dewitt Fld Municipal	OLD
Olean	OLE	Cattaraugus County	OLE
Olekminsk	OLZ	Olekminsk	OLZ
Olenek	ONK	Olenek	ONK
Olive Branch	OLV	Olive Branch	OLV
Olkiombo	OLX	Olkiombo	OLX
Olney	ONY	Municipal	ONY
Olney/Noble	OLY	Olney/Noble	OLY
Olomouc	OLO	Neredin	OLO
Olpoi	OLJ	North West Santo	OLJ
Olsobip	OLQ	Olsobip	OLQ
Olympia	OLM	Regional	OLM
Olympic Dam	OLP	Olympic Dam	OLP
Omaha	OMA	Millard	MIQ
Omaha	OMA	Offutt AFB	OFF
Omaha	OMA	Metropolitan Area	OMA
Omaha	OMA	Eppley Airfield	OMA
Omak	OMK	Omak	OMK
Omboue	OMB	Omboue-Hopital	OMB
Omega	OMG	Omega	OMG
Omidiyeh	OMI	Omidiyeh	OMI
Omkalai	OML	Omkalai	OML
Omora	OSE	Omora	OSE
Omsk	OMS	Tsentralny	OMS
Ondangwa	OND	Ondangwa	OND
O'Neill	ONL	Municipal	ONL
Oneonta	ONH	Municipal	ONH
Onepusu	ONE	Onepusu	ONE
Ongava	OGV	Ongava	OGV
Ono-i-Lau	ONU	Ono-i-Lau	ONU
Ononge	ONB	Ononge	ONB
Onotoa	OOT	Onotoa	OOT
Onslow	ONS	Onslow	ONS
Ontario	ONO	Municipal	ONO
Ontario	ONT	International	ONT
Ontong Java Atoll	OTV	Ontong Java Atoll	OTV
Oodnadatta	ODD	Oodnadatta	ODD
Oostende/Brugge	OST	Airport	OST
Opelousas	OPL	St Landry Parish	OPL
Open Bay	OPB	Open Bay	OPB
Opuwo	OPW	Opuwo	OPW
Oradea	OMR	Oradea	OMR
Oran	ORA	Oran	ORA
Oran	ORN	Metropolitan Area	ORN
Oran	ORN	Ahmed Ben Bella	ORN
Oran	ORN	Tafaraoui	TAF
Orange	OAG	Orange	OAG
Orange Walk	ORZ	Orange Walk	ORZ
Orangeburg	OGB	Municipal	OGB
Oranjemund	OMD	Oranjemund	OMD
Orapa	ORP	Orapa	ORP
Ord River	ODR	Ord River	ODR
Ordu/Giresun	OGU	Ordu/Giresun	OGU
Orebro	ORB	Airport	ORB
Orel	OEL	Yuzhny	OEL
Oria	OTY	Oria	OTY
Orientos	OXO	Orientos	OXO
Orinduik	ORJ	Orinduik	ORJ
Oriximina	ORX	Oriximina	ORX
Orland	OLA	Orland	OLA
Orlando	ORL	Kissimmee Gateway	ISM
Orlando	ORL	International	MCO
Orlando	ORL	Metropolitan Area	ORL
Orlando	ORL	Executive	ORL
Orlando	ORL	Sanford Intl	SFB
Orleans	ORE	St Denis de l'Hotel	ORE
Ormara	ORW	Ormara	ORW
Ormoc	OMC	Ormoc	OMC
Ornskoldsvik	OER	Ornskoldsvik	OER
Orocue	ORC	Orocue	ORC
Oroville	OVE	Municipal	OVE
Orpheus Island	ORS	Waterport SPB	ORS
Orsk	OSW	Orsk	OSW
Oruro	ORU	Juan Mendoza	ORU
Osage Beach	OSB	Grand Glaize	OSB
Osaka	OSA	Osaka Intl (Itami)	ITM
Osaka	OSA	Kansai International	KIX
Osaka	OSA	Metropolitan Area	OSA
Osaka	OSA	Kobe	UKB
Osan	OSN	Air Base	OSN
Osborne Mine	OSO	Osborne Mine	OSO
Osceola	OEO	L.O. Simenstad Muni	OEO
Oscoda	OSC	Wurtsmith	OSC
Osh	OSS	Osh	OSS
Oshakati	OHI	Oshakati	OHI
Oshima	OIM	Oshima	OIM
Oshkosh	OKS	Garden County	OKS
Oshkosh	OSH	Wittman Regional	OSH
Osijek	OSI	Osijek	OSI
Oskaloosa	OOA	Municipal	OOA
Oskarshamn	OSK	Oskarshamn	OSK
Oslo	OSL	Metropolitan Area	OSL
Oslo	OSL	Gardermoen	OSL
Oslo	OSL	Moss-Rygge	RYG
Oslo	OSL	Sandefjord-Torp	TRF
Ossima	OSG	Ossima	OSG
Ostrava	OSR	Leos Janacek	OSR
Otjiwarongo	OTJ	Otjiwarongo	OTJ
Ottumwa	OTM	Regional	OTM
Ouadda	ODA	Ouadda	ODA
Ouagadougou	OUA	Ouagadougou	OUA
Ouahigouya	OUG	Ouahigouya	OUG
Ouanda Djalle	ODJ	Ouanda Djalle	ODJ
Ouanga	OUU	Ouanga	OUU
Ouango Fitini	OFI	Ouango Fitini	OFI
Ouargla	OGX	Ain el Beida	OGX
Ouarzazate	OZZ	Ouarzazate	OZZ
Oudtshoorn	OUH	Oudtshoorn	OUH
Ouesso	OUE	Ouesso	OUE
Oujda	OUD	Angads	OUD
Oulu	OUL	Oulu	OUL
Oum Hadjer	OUM	Oum Hadjer	OUM
Ourilandia do Norte	OIA	Ourilandia do Norte	OIA
Ourinhos	OUS	Benedito Pimentel	OUS
Out Skerries	OUK	Out Skerries	OUK
Ouyen	OYN	Ouyen	OYN
Ovalle	OVL	El Tuqui	OVL
Overberg	OVG	AFB	OVG
Owatonna	OWA	Degner Regional	OWA
Owendo	OWE	Owendo	OWE
Owensboro	OWB	Daviess County	OWB
Oxford	OXC	Waterbury-Oxford	OXC
Oxford	OXD	Miami University	OXD
Oxford	OXF	London Oxford	OXF
Oxnard/Ventura	OXR	Oxnard Apt	OXR
Oyem	OYE	Oyem	OYE
Oyo	OLL	Ollombo	OLL
Ozamis	OZC	Labo	OZC
Ozona	OZA	Municipal	OZA
Paloemeu	OEM	Vincent Fayks	OEM
Paramaribo	PBM	Zorg en Hoop	ORG
Paris	PAR	Orly	ORY
Podolsk	OSF	Ostafyevo	OSF
Port Lions	ORI	Port Lions	ORI
Porto	OPO	Francisco Sa Carneiro	OPO
Remedios	OTU	Otu	OTU
Salerno	OLR	Air Base	OLR
San Antonio Oeste	OES	Antoine de St Exupery	OES
Sao Paulo de Olivenca	OLC	Sen. Eunice Micheles	OLC
Sapporo	SPK	Okadama	OKD
Sarmiento	OLN	Lago Musters	OLN
Shank	OAA	Air Base	OAA
Sharana	OAS	Air Base	OAS
Shindand	OAH	Air Base	OAH
Sinop	OPS	Jao B. Figueiredo	OPS
Socorro	ONM	Municipal	ONM
Sohar	OHS	Sohar	OHS
Sovetsky	OVS	Sovetsky	OVS
St-Georges (Oyapock)	OYP	St-Georges (Oyapock)	OYP
Thbeng Meanchey	OMY	Preah Vinhear	OMY
Tillamook	OTK	Tillamook	OTK
Toksook Bay	OOK	Toksook Bay	OOK
Tokyo	TYO	Yokota AB	OKO
Tres Arroyos	OYO	Tres Arroyos	OYO
Urumiyeh	OMH	Urumiyeh	OMH
Ustupo Island	OGM	Ustupo Ogobsucum	OGM
Vladikavkaz	OGZ	Beslan	OGZ
Washington	OCW	Warren Field	OCW
Winona	ONA	Municipal	ONA
Wolf Point	OLF	L.M. Clayton	OLF
Worcester	ORH	Regional	ORH
Worthington	OTG	Municipal	OTG
Wyk auf Foehr	OHR	Wyk Auf Foehr	OHR
Yonaguni	OGN	Yonaguni	OGN
Yorke Island	OKR	Yorke Island	OKR
Yorketown	ORR	Yorketown	ORR
Yoro	ORO	Yoro	ORO
Zagora	OZG	Zagora	OZG
Zaporizhzhia	OZH	Mokraya Intl	OZH
Zoersel	OBL	Oostmalle	OBL
Zonguldak	ONQ	Caycuma	ONQ
Zouerate	OUZ	Tazadit	OUZ

Displaying 332 result(s)