Search results for "Q"
CITY NAME	3-LETTER CITY CODE	AIRPORT NAME	3-LETTER AIRPORT CODE
Bella Coola	QBC	Bella Coola	QBC
Charlotte	CLT	Wilgrove Air Park	QWG
Chichester	QUG	Goodwood	QUG
Coningsby	QCY	RAF Station	QCY
Husum	QHU	Schwesing	QHU
Johannesburg	JNB	Rand	QRA
L'Aquila	QAQ	L'Aquila	QAQ
Owerri	QOW	Sam Mbakwe Intl	QOW
Queretaro	QRO	Intercontinental	QRO
Salerno	QSR	Pontecagnano	QSR
Sao Carlos	QSC	Mario Pereira Lopes	QSC
Setif	QSF	8 Mai 45	QSF
Singapore	SIN	Paya Lebar	QPG
Ubari	QUB	Ubari	QUB
Uyo	QUO	Akwa Ibom Intl	QUO
Warri	QRW	Osubi	QRW
Wyton	QUY	RAF Station	QUY

Displaying 17 result(s)