Search results for "Z"
CITY NAME	3-LETTER CITY CODE	AIRPORT NAME	3-LETTER AIRPORT CODE
108 Mile Ranch	ZMH	South Cariboo Regional	ZMH
Alice Arm	ZAA	Silver City SPB	ZAA
Ancud	ZUD	Pupelde	ZUD
Andapa	ZWA	Andapa	ZWA
Baku	BAK	Zabrat	ZXT
Bathurst	ZBF	Bathurst	ZBF
Bella Bella	ZEL	Shearwater SPB	YSX
Bella Bella	ZEL	Campbell Island	ZEL
Biloela	ZBL	Biloela	ZBL
Bowen	ZBO	Bowen	ZBO
Bromont	ZBM	Roland-Desourdy	ZBM
Cahors	ZAO	Lalbenque	ZAO
Chah Bahar	ZBR	Konarak	ZBR
Churchill Falls	ZUM	Churchill Falls	ZUM
Delma Island	ZDY	Delma Island	ZDY
Eastmain	ZEM	Eastmain River	ZEM
Fairview	ZFW	Fairview	ZFW
Faro	ZFA	Faro	ZFA
Fond-du-Lac	ZFD	Fond-du-Lac	ZFD
Fort McPherson	ZFM	Fort McPherson	ZFM
Gaua Island	ZGU	Gaua Island	ZGU
Gods River	ZGI	Gods River	ZGI
Grand Forks	ZGF	Grand Forks	ZGF
High Prairie	ZHP	High Prairie	ZHP
Ignace	ZUC	Municipal	ZUC
Ixtapa/Zihuatanejo	ZIH	International	ZIH
Jenpeg	ZJG	Jenpeg	ZJG
Kasaba Bay	ZKB	Kasaba Bay	ZKB
Kashechewan	ZKE	Kashechewan	ZKE
Kegaska	ZKG	Kegaska	ZKG
La Romaine	ZGS	La Romaine	ZGS
La Tabatiere	ZLT	La Tabatiere	ZLT
Little Grand Rapids	ZGR	Little Grand Rapids	ZGR
Manzanillo	ZLO	Playa de Oro Intl	ZLO
Masset	ZMT	Masset	ZMT
Miandrivazo	ZVA	Miandrivazo	ZVA
Mzuzu	ZZU	Mzuzu	ZZU
Namu	ZNU	SPB	ZNU
Nanaimo	YCD	Harbour SPB	ZNA
Newman	ZNE	Newman	ZNE
Ngoma	ZGM	Ngoma	ZGM
Nyac	ZNC	Nyac	ZNC
Ocean Falls	ZOF	SPB	ZOF
Osorno	ZOS	Canal Bajo	ZOS
Pasir Gudang	ZLW	Pasir Gudang Port	ZLW
Pinehouse	ZPO	Pinehouse Lake	ZPO
Prince Rupert	YPR	Seal Cove SPB	ZSW
Pucon	ZPC	Pucon	ZPC
Queen Charlotte	ZQS	SPB	ZQS
Queenstown	ZQN	Queenstown	ZQN
Round Lake	ZRJ	Weagamow Lake	ZRJ
Saarbruecken	SCN	Zweibruecken	ZQW
Sachigo Lake	ZPB	Sachigo Lake	ZPB
San Salvador	ZSA	Cockburn Town	ZSA
Sandy Lake	ZSJ	Sandy Lake	ZSJ
Sarmi	ZRM	Orai	ZRM
Sassandra	ZSS	Sassandra	ZSS
Savannakhet	ZVK	Savannakhet	ZVK
Sayaboury	ZBY	Sayaboury	ZBY
Secunda	ZEC	Secunda	ZEC
Sena Madureira	ZMD	Sena Madureira	ZMD
Senggo	ZEG	Senggo	ZEG
Serui	ZRI	S.Condronegoro	ZRI
Shamattawa	ZTM	Shamattawa	ZTM
Shamshernagar	ZHM	Shamshernagar	ZHM
South Galway	ZGL	South Galway	ZGL
Springvale	ZVG	Springvale	ZVG
Stewart	ZST	Stewart	ZST
St-Pierre	ZSE	Pierrefonds	ZSE
Swan River	ZJN	Swan River	ZJN
Sylhet	ZYL	Osmani Intl	ZYL
Tahsis	ZTS	SPB	ZTS
Tanjung Pelepas	ZJT	Tanjung Pelepas Port	ZJT
Temuco	ZCO	Maquehue	PZS
Temuco	ZCO	La Araucania	ZCO
Tete-a-la Baleine	ZTB	Tete-a-la Baleine	ZTB
Tulita	ZFN	Tulita	ZFN
Tureia	ZTA	Tureia	ZTA
Valdivia	ZAL	Pichoy	ZAL
Victoria	ZIC	Victoria	ZIC
Wollaston Lake	ZWL	Wollaston Lake	ZWL
York Landing	ZAC	York Landing	ZAC
Zabljak	ZBK	Zabljak	ZBK
Zabreh	ZBE	Zabreh	ZBE
Zacatecas	ZCL	Leobardo C. Ruiz Intl	ZCL
Zadar	ZAD	Zadar	ZAD
Zagreb	ZAG	Pleso	ZAG
Zahedan	ZAH	International	ZAH
Zakinthos Island	ZTH	Dionisios Salomos	ZTH
Zalengei	ZLX	Zalengei	ZLX
Zamboanga	ZAM	International	ZAM
Zamora	ZMM	Zamora	ZMM
Zamzama	ZIZ	Zamzama	ZIZ
Zanesville	ZZV	Municipal	ZZV
Zanzibar	ZNZ	International	ZNZ
Zaqatala	ZTU	Zaqatala	ZTU
Zaragoza	ZAZ	Airport	ZAZ
Zaranj	ZAJ	Zaranj	ZAJ
Zaria	ZAR	Zaria	ZAR
Zenag	ZEN	Zenag	ZEN
Zephyrhills	ZPH	Municipal	ZPH
Zhangjiakou	ZQZ	Zhangjiakou	ZQZ
Zhanjiang	ZHA	Zhanjiang	ZHA
Zhaotong	ZAT	Zhaotong	ZAT
Zhigansk	ZIX	Zhigansk	ZIX
Zhongwei	ZHY	Xiangshan	ZHY
Zhuhai	ZUH	Sanzao Intl	ZUH
Zhukovsky	ZIA	Zhukovsky	ZIA
Zhytomyr	ZTR	Zhytomyr	ZTR
Ziguinchor	ZIG	Ziguinchor	ZIG
Zilfi	ZUL	Zilfi	ZUL
Zinder	ZND	Zinder	ZND
Zintan	ZIS	Zintan	ZIS
Ziro	ZER	Ziro	ZER
Zonalnoye	ZZO	Zonalnoye	ZZO
Zunyi	ZYI	Xinzhou	ZYI
Zurich	ZRH	Metropolitan Area	ZRH
Zurich	ZRH	Zurich Airport	ZRH
Zyryanka	ZKP	Zyryanka	ZKP

Displaying 119 result(s)